[
[9,9,9,9,9,9,9,9,9,9,9,9,9,9,9,9,9,9,9,9,9,9,9,9,9,9,9,9,9,9,9,9,9,9,9,9,9,9,9,9,9,9,9,9,9,9,9,9,9,9,9,9,9,9,9,9,10,10,10,10,10,10,10,10,10,10,10,10,10,10,10,10,10,10,10,10,10,10,10,10,10,12,12,12,12,12,12,12,12,12,12,12,12,12,12,12,12,12,12,12,12,12,12,12,12,12,12,12,12,12,12,12,12,12,12,12,15,15,15,15,15,15,15,15,15,15,15,15,15,15,15,15,15,15,15,15,15,15,15,15,15,15,15,15,15,15,15,15,15,15,15,15,15,15,15,15],
[1,1,1,1,1,1,1,1,1,1,1,1,1,1,15,15,15,15,15,15,15,15,15,15,1,1,1,1,1,1,1,1,1,1,1,1,1,1,1,1,1,1,1,1,1,1,10,10,10,10,10,10,10,10,10,10,3,3,10,10,3,3,3,10,10,10,10,10,10,10,10,10,10,10,10,10,10,10,12,12,12,12,12,12,12,12,12,12,1,1,1,1,1,1,1,12,1,1,1,1,15,1,1,1,1,1,1,1,1,1,1,15,15,15,15,15,15,15,15,15,1,1,1,1,1,1,1,1,1,1,15,15,15,15,15,15,15,15,15,15,15,15,15,15,15,15,15,15,15,15,15,15,15,15,15,15],
[15,11,11,11,11,11,11,11,15,15,15,1,1,1,3,10,10,10,10,10,10,10,10,1,1,1,1,10,10,10,10,10,10,10,10,10,10,10,10,10,10,10,10,1,1,1,1,10,10,10,10,10,10,10,10,10,3,10,3,10,10,3,10,10,10,10,10,10,10,10,10,10,10,10,10,10,10,12,12,12,12,12,12,12,12,12,12,1,1,1,1,12,1,1,1,1,1,1,1,1,15,1,1,1,1,1,1,15,1,1,1,1,15,15,15,15,15,15,15,15,1,1,1,1,1,1,15,1,1,1,1,15,15,15,15,15,15,15,15,15,15,15,15,15,15,15,15,15,15,15,15,15,15,15,15,15],
[15,11,11,11,11,11,11,11,15,15,15,1,1,1,1,1,10,10,10,10,10,10,1,1,1,1,1,10,10,10,10,10,10,10,10,10,10,10,10,10,10,1,1,10,1,1,1,1,1,1,1,1,1,1,1,10,3,3,3,10,10,3,10,10,10,10,10,10,1,1,1,3,3,3,3,3,3,3,3,3,1,1,1,1,1,1,1,1,1,1,12,12,1,1,1,1,1,12,1,1,1,1,1,1,1,1,1,15,1,1,1,1,1,15,15,15,15,15,15,15,1,1,1,1,1,15,15,1,1,1,1,1,15,15,15,15,15,15,15,15,15,15,15,1,1,1,1,1,1,1,1,1,1,1,1,1],
[15,11,11,11,11,11,11,11,15,15,15,1,1,1,1,1,1,1,1,1,1,1,1,1,1,1,1,10,10,10,10,10,10,10,10,10,10,10,10,10,10,1,1,1,10,1,1,1,1,1,1,1,1,1,1,10,3,10,3,10,10,3,10,10,10,10,10,10,1,1,10,10,10,10,10,10,10,10,12,12,12,12,12,12,12,12,12,12,12,12,12,12,12,12,12,12,12,12,12,12,12,12,12,12,12,12,12,15,1,1,1,1,1,1,15,15,15,15,15,15,1,1,1,1,15,15,15,1,1,1,1,1,1,15,15,15,15,15,15,15,15,15,1,1,1,1,15,15,15,15,15,15,15,15,15,15],
[15,11,11,11,11,11,11,11,15,15,15,15,15,15,15,15,15,15,15,15,15,15,15,15,9,9,9,10,10,10,9,9,9,10,10,10,10,10,10,10,10,2,2,2,2,10,10,10,2,2,2,2,2,2,2,10,3,3,10,1,10,3,10,1,10,1,1,1,1,1,10,10,10,10,10,10,10,10,12,12,12,12,12,12,12,12,12,1,1,1,1,1,1,1,12,12,12,12,12,12,1,1,1,1,1,1,15,15,1,1,1,1,1,1,1,1,1,1,1,1,1,1,1,15,15,15,15,1,1,1,1,1,1,1,1,1,1,1,1,1,1,1,1,1,1,1,15,15,15,15,15,15,15,15,15,15],
[15,11,11,11,11,11,11,11,15,15,15,1,1,1,1,1,1,1,1,1,1,1,1,1,1,1,1,10,10,10,10,10,10,10,10,10,10,10,10,10,10,1,1,1,1,1,1,1,1,1,1,1,1,1,1,10,10,10,10,10,10,10,10,10,10,1,1,1,1,1,10,10,10,10,10,10,10,10,12,12,12,12,12,12,12,12,12,1,1,1,1,1,1,1,1,12,12,12,12,12,1,1,1,1,1,1,1,15,1,1,1,1,1,1,1,1,1,1,1,1,1,1,1,15,15,15,15,1,1,1,1,1,1,1,1,1,1,1,1,1,1,1,1,1,1,1,15,15,15,15,15,15,15,15,15,15],
[15,11,11,11,11,11,11,11,15,15,15,1,1,1,1,1,10,10,10,10,10,10,1,1,1,1,1,10,10,10,10,10,10,10,10,10,10,10,10,10,10,1,1,10,1,1,1,1,1,10,1,1,1,1,1,10,10,10,10,10,10,10,10,10,10,1,1,1,1,1,10,10,10,10,10,10,10,10,12,12,12,12,12,12,12,12,12,1,1,1,1,12,1,1,1,1,12,12,12,12,1,1,1,1,1,1,1,15,1,1,1,1,1,15,15,15,15,15,15,15,1,1,1,1,15,15,15,1,1,1,1,1,15,15,15,15,15,15,15,15,15,15,1,1,1,1,1,15,15,15,15,15,15,15,15,15],
[15,15,15,15,15,15,15,15,15,15,15,1,1,1,1,10,10,10,10,10,10,10,10,1,1,1,1,10,10,10,10,10,10,10,10,10,10,10,10,10,10,1,1,1,1,1,1,10,1,1,1,1,1,1,1,1,1,1,1,1,1,1,1,1,1,1,1,1,1,1,1,1,1,1,1,1,1,1,1,1,1,1,1,1,1,1,1,1,1,1,12,12,1,1,1,1,1,12,12,1,1,1,1,12,1,1,1,1,1,1,1,1,15,15,15,15,15,15,15,15,1,1,1,1,1,15,15,1,1,1,1,15,15,15,15,15,15,15,15,15,15,15,15,1,1,1,1,1,15,15,15,15,15,15,15,15],
[1,1,0,1,1,1,1,1,1,1,1,1,1,1,15,15,15,15,15,15,15,15,15,15,1,1,1,1,1,1,1,1,1,1,1,1,1,1,1,1,1,1,1,1,10,1,1,1,1,1,1,1,1,1,1,1,1,1,1,1,1,1,1,1,1,1,1,1,1,1,10,10,10,10,10,10,10,10,12,12,12,12,12,12,12,12,1,1,1,12,12,12,1,1,1,1,1,1,1,1,1,1,12,12,1,1,1,1,1,1,1,15,15,15,15,15,15,15,15,15,1,1,1,1,1,1,1,1,1,1,15,15,15,15,15,15,15,15,15,15,15,15,15,15,1,1,1,1,1,1,1,1,1,1,1,1],
[9,9,9,9,9,9,9,9,9,9,9,9,9,9,9,9,9,9,9,9,9,9,9,9,9,9,9,9,9,9,9,9,9,9,9,9,9,9,9,9,9,9,9,9,9,9,9,9,9,9,9,9,9,9,9,9,10,10,10,10,10,10,10,10,10,10,10,10,10,10,10,10,10,10,10,10,10,10,10,10,10,12,12,12,12,12,12,12,12,12,12,12,12,12,12,12,12,12,12,12,12,12,12,12,12,12,12,12,12,12,12,12,12,12,12,12,15,15,15,15,15,15,15,15,15,15,15,15,15,15,15,15,15,15,15,15,15,15,15,15,15,15,15,15,15,15,15,15,15,15,15,15,15,15,15,15]
];
