[
[9,9,9,9,9,9,9,9,9,9,9,9,9,9,9,9,9,9,9,9,9,9,9,9,9,9,9,9,9,9,9,9,9,9,9,9,9,9,9,9,9,9,9,9,9,9,9,9,9,9,9,9,9,9,9,9,10,10,10,10,10,10,10,10,10,10,10,10,10,10,10,10,10,10,10,10,10,10,10,10,10,12],
[11,11,11,11,11,11,11,11,11,11,11,11,1,1,1,1,1,1,1,1,1,1,1,1,1,1,1,1,1,1,1,1,9,9,9,9,9,9,9,9,9,1,1,1,1,1,3,3,3,3,9,3,3,3,3,3,3,3,3,3,3,3,3,3,3,3,3,3,3,3,3,3,3,3,3,3,3,3,3,3,3,3],
[11,11,11,11,11,11,11,11,11,11,11,1,1,1,3,11,11,11,11,11,11,11,11,1,1,1,1,1,1,11,1,1,1,9,9,9,9,9,9,9,2,2,2,1,9,9,9,9,9,9,9,3,3,3,3,3,3,3,3,10,3,3,3,3,3,3,3,3,3,3,3,3,3,10,10,10,10,12,12,12,12,12],
[11,11,11,11,11,11,11,11,11,11,1,1,1,1,11,11,6,6,10,11,11,11,11,11,11,11,11,11,11,11,11,1,1,2,9,9,9,9,9,2,2,1,1,9,9,9,9,9,9,9,9,1,1,1,1,3,3,3,3,3,3,3,3,3,3,3,3,3,1,1,1,3,3,10,10,9,9,9,9,9,9,9],
[1,1,1,1,1,1,1,1,1,1,1,1,1,11,11,11,6,11,6,11,11,11,9,6,11,11,11,11,11,11,11,1,1,2,4,9,9,9,2,2,2,1,9,9,9,9,9,9,9,9,9,1,1,1,10,3,3,3,3,3,3,10,3,3,3,10,3,3,1,1,3,3,3,10,10,10,10,10,12,12,12,12],
[1,1,1,1,1,1,1,1,1,1,1,1,1,11,11,11,6,6,6,11,6,6,11,11,9,6,11,11,11,11,11,1,1,2,2,2,2,2,2,2,2,2,4,9,2,10,3,3,2,2,2,2,2,2,2,3,10,3,3,1,3,3,3,3,3,1,1,1,1,1,3,3,3,10,10,10,10,10,12,12,12,12],
[11,11,11,11,11,11,11,11,11,11,1,1,1,1,11,11,6,11,6,11,6,11,9,6,9,6,6,6,11,11,11,1,1,2,9,9,9,9,9,9,2,1,4,1,1,5,10,1,1,1,1,10,1,1,1,3,3,3,3,3,3,3,3,3,3,1,1,10,1,1,3,3,3,10,10,10,10,10,12,12,12,12],
[11,11,11,11,11,11,11,11,11,11,11,1,1,1,1,11,6,6,10,11,6,11,9,6,9,6,9,6,11,11,11,1,1,2,2,9,9,9,9,2,2,10,10,2,1,1,3,1,1,3,1,1,1,1,1,3,3,3,3,10,3,3,3,3,10,1,1,1,1,1,3,3,3,10,10,10,10,10,12,12,12,12],
[11,11,11,11,11,11,11,11,11,11,11,11,1,1,1,1,11,11,11,11,11,11,11,9,9,9,9,9,9,1,3,1,1,2,2,2,9,9,2,2,2,1,1,1,1,1,1,3,1,1,1,1,1,1,10,1,1,1,1,1,2,1,1,1,1,1,1,1,1,1,1,1,1,9,9,9,9,9,9,9,9,9],
[11,11,11,11,11,11,11,11,11,11,11,11,11,1,1,1,1,1,1,1,1,1,1,1,1,1,3,1,1,1,1,1,10,3,1,1,2,2,1,1,1,10,1,1,3,1,1,1,1,10,1,1,1,1,1,1,1,1,1,1,1,1,10,1,1,1,1,1,1,1,3,3,3,3,3,3,3,3,3,3,3,3],
[9,9,9,9,9,9,9,9,9,9,9,9,9,9,9,9,9,9,9,9,9,9,9,9,9,9,9,9,9,9,9,9,9,9,9,9,9,9,9,9,9,9,9,9,9,9,9,9,9,9,9,9,9,9,9,9,10,10,10,10,10,10,10,10,10,10,10,10,10,10,10,10,10,10,10,10,10,10,10,10,10,12]
];