[
[9,9,9,9,9,9,9,9,9,9,9,9,9,9,9,9,9,9,9,9,9,9,9,9,9,9,9,9,9,9,9,9,9,9,9,9,9,9,9,9,9,9,9,9,9,9,9,9,9,9,9,9,9,9,9,9,10,10,10,10,10,10,10,10,10,10,10,10,10,10,10,10,10,10,10,10,10,10,10,10,10,12,12,12,12,12,12,12,12,12,12,12,12,12,12,12,12,12,12,12,12,12,12,12,12,12,12,12,12,12,12,12,12,12,12,12,15,15,15,15,15,15,15,15,15,15,15,15,15,15,15,15,15,15,15,15,15,15,15,15,15,15,15,15,15,15,15,15,15,15,15,15,15,15,15,15,2,2,2,2,2,2],
[10,10,10,10,10,10,10,10,10,10,10,10,10,10,10,10,10,10,10,10,10,10,10,10,10,10,1,1,1,1,1,1,1,1,1,1,1,10,2,2,2,1,1,1,1,1,2,2,2,3,3,3,3,3,3,3,3,3,10,10,10,3,3,10,10,10,10,10,10,10,10,10,10,10,10,10,10,10,12,12,12,12,12,12,12,12,12,12,1,1,1,1,1,1,1,12,1,1,1,1,15,1,1,1,1,1,1,1,1,1,1,15,15,15,15,15,15,15,15,15,1,1,1,1,1,1,1,1,1,1,15,15,15,15,15,15,15,15,15,15,15,15,15,15,15,15,15,15,15,15,15,15,15,15,15,15,1,1,1,1,1,1],
[10,10,10,10,10,10,10,10,10,10,10,10,10,10,10,10,10,10,10,10,10,10,10,10,10,10,1,1,1,1,1,1,2,2,2,2,2,2,2,2,2,2,2,1,1,1,10,10,10,10,10,10,10,10,10,3,3,3,3,3,3,3,10,10,10,10,10,10,10,10,10,10,10,10,10,10,10,12,12,12,12,12,12,12,12,12,12,1,1,1,1,12,1,1,1,1,1,1,1,1,15,1,1,1,1,1,1,15,1,1,1,1,15,15,15,15,15,15,15,15,1,1,1,1,1,1,15,1,1,1,1,15,15,15,15,15,15,15,15,15,15,15,15,15,15,15,15,15,15,15,15,15,15,15,15,15,1,1,1,1,1,1],
[1,1,1,1,1,1,1,1,10,10,10,1,1,1,1,1,1,1,10,10,10,10,10,1,1,1,6,1,1,1,1,1,2,2,2,2,2,10,2,2,2,1,1,2,10,10,1,1,1,1,1,1,1,1,10,3,3,3,3,3,3,3,10,10,10,10,10,10,1,1,1,3,3,3,3,3,3,3,3,3,1,1,1,1,1,1,1,1,1,1,12,12,1,1,1,1,1,12,1,1,1,1,1,1,1,1,1,15,1,1,1,1,1,15,15,15,15,15,15,15,1,1,1,1,1,15,15,1,1,1,1,1,15,15,15,15,15,15,15,15,15,15,15,1,1,1,1,1,1,1,1,1,1,1,1,1,1,1,1,1,1,1],
[1,1,1,1,1,1,1,1,1,1,1,1,1,1,1,1,1,1,1,1,1,1,1,1,1,1,1,10,10,10,10,10,10,10,10,10,10,10,2,2,2,10,11,10,2,1,1,1,1,1,1,1,1,1,10,3,3,3,3,3,3,3,10,10,10,10,10,10,1,1,10,10,10,10,10,10,10,10,12,12,12,12,12,12,12,12,12,12,12,12,12,12,12,12,12,12,12,12,12,12,12,12,12,12,12,12,12,15,1,1,1,1,1,1,15,15,15,15,15,15,1,1,1,1,15,15,15,1,1,1,1,1,1,15,15,15,15,15,15,15,15,15,1,1,1,1,15,15,15,15,15,15,15,15,15,15,1,1,1,1,1,1],
[1,1,1,1,1,1,1,1,1,1,1,1,1,1,1,1,1,1,1,1,1,1,1,1,1,1,10,1,1,1,1,1,2,2,2,2,2,2,10,10,10,2,2,2,2,2,2,2,2,2,2,2,2,2,10,3,3,3,3,3,3,3,10,1,10,1,1,1,1,1,10,10,10,10,10,10,10,10,12,12,12,12,12,12,12,12,12,1,1,1,1,1,1,1,12,12,12,12,12,12,1,1,1,1,1,1,15,15,1,1,1,1,1,1,1,1,1,1,1,1,1,1,1,15,15,15,15,1,1,1,1,1,1,1,1,1,1,1,1,1,1,1,1,1,1,1,15,15,15,15,15,15,15,15,15,15,1,1,1,1,1,1],
[1,1,1,1,1,1,1,1,1,1,1,1,1,1,1,1,1,1,1,1,1,1,1,1,1,1,10,1,1,1,1,1,2,2,2,2,2,2,10,2,2,1,1,1,1,1,1,1,1,1,1,1,1,1,1,3,3,3,3,10,3,10,10,10,10,1,1,1,1,1,10,10,10,10,10,10,10,10,12,12,12,12,12,12,12,12,12,1,1,1,1,1,1,1,1,12,12,12,12,12,1,1,1,1,1,1,1,15,1,1,1,1,1,1,1,1,1,1,1,1,1,1,1,15,15,15,15,1,1,1,1,1,1,1,1,1,1,1,1,1,1,1,1,1,1,1,15,15,15,15,15,15,15,15,15,15,1,1,1,1,1,1],
[1,1,1,1,1,1,1,1,10,10,10,1,1,1,1,1,1,1,1,1,1,1,10,1,1,1,1,10,1,1,1,1,2,2,2,2,2,2,10,10,10,10,10,10,10,10,10,10,10,10,10,1,1,1,3,3,3,3,3,10,3,10,10,10,10,1,1,1,1,1,10,10,10,10,10,10,10,10,12,12,12,12,12,12,12,12,12,1,1,1,1,12,1,1,1,1,12,12,12,12,1,1,1,1,1,1,1,15,1,1,1,1,1,15,15,15,15,15,15,15,1,1,1,1,15,15,15,1,1,1,1,1,15,15,15,15,15,15,15,15,15,15,1,1,1,1,1,15,15,15,15,15,15,15,15,15,1,1,1,1,1,1],
[10,10,10,10,10,10,10,10,10,10,10,10,10,10,10,10,10,10,10,10,10,10,10,1,1,1,1,1,10,1,1,1,2,2,2,2,2,2,2,2,2,1,1,1,1,1,1,2,1,1,10,1,1,1,1,1,1,1,1,10,1,1,1,1,1,1,1,1,1,1,1,1,1,1,1,1,1,1,1,1,1,1,1,1,1,1,1,1,1,1,12,12,1,1,1,1,1,12,12,1,1,1,1,12,1,1,1,1,1,1,1,1,15,15,15,15,15,15,15,15,1,1,1,1,1,15,15,1,1,1,1,15,15,15,15,15,15,15,15,15,15,15,15,1,1,1,1,1,15,15,15,15,15,15,15,15,1,1,1,1,1,1],
[10,10,10,10,10,10,10,10,10,10,10,10,10,10,10,10,10,10,10,10,10,10,10,1,1,1,1,1,4,1,1,1,1,1,1,1,2,1,1,2,2,1,1,1,2,1,1,1,5,1,1,1,1,1,1,1,1,1,1,10,1,1,1,1,1,1,1,1,1,1,10,10,10,10,10,10,10,10,12,12,12,12,12,12,12,12,1,1,1,12,12,12,1,1,1,1,1,1,1,1,1,1,12,12,1,1,1,1,1,1,1,15,15,15,15,15,15,15,15,15,1,1,1,1,1,1,1,1,1,1,15,15,15,15,15,15,15,15,15,15,15,15,15,15,1,1,1,1,1,1,1,1,1,1,1,1,1,1,1,1,1,1],
[9,9,9,9,9,9,9,9,9,9,9,9,9,9,9,9,9,9,9,9,9,9,9,9,9,9,9,9,9,9,9,9,9,9,9,9,9,9,9,9,9,9,9,9,9,9,9,9,9,9,9,9,9,9,9,9,10,10,10,10,10,10,10,10,10,10,10,10,10,10,10,10,10,10,10,10,10,10,10,10,10,12,12,12,12,12,12,12,12,12,12,12,12,12,12,12,12,12,12,12,12,12,12,12,12,12,12,12,12,12,12,12,12,12,12,12,15,15,15,15,15,15,15,15,15,15,15,15,15,15,15,15,15,15,15,15,15,15,15,15,15,15,15,15,15,15,15,15,15,15,15,15,15,15,15,15,2,2,2,2,2,2]
];

